[
    [
        "...#..................#...................#......................#..............................#.............................#..."
    ],
    [
        "....#.......................#........#.#..............##...........#.....#..........#..........................#.................."
    ],
    [
        ".............#.........................XXXXXXXXXXXXXXXXXXXXXXXXXXXXXXXXXX>#...........#.........#.#..#..#..........#.............."
    ],
    [
        "..........#.......#..........#.........X........#........##...................#..............#...................................."
    ],
    [
        "....................#..................X.......................................#..#.....................................#........."
    ],
    [
        "....#............................#.....X........................................#.....................#..........##....#.........."
    ],
    [
        ".......#.............#.................X....................................................#.............#.........#............."
    ],
    [
        "....###......................#....#....X......#.....#................................#..........................#................."
    ],
    [
        "..........#..#...........#..#..........X......XXXXXXXXXXXXXXXXXXXXXXXXXXXXXXXXXXXXXXX#.....#...........#................#........."
    ],
    [
        "..#....#......#....#....#XXXXXXXXXXXXXXXXXXXXXXXXXXXXXXXXXXXXXXXXXXXXXXXXXXXXXXXXXXXXXXXXXXX#....................................."
    ],
    [
        "....................#....X.......#.....X......X...............................#.....X#....#X..............................#......."
    ],
    [
        "..........#.......#......X..#.......#..X......X.....................................X......X......................................"
    ],
    [
        ".......#...#.............X..XXXXXXXXXXXXXXXXXXXXXXX#...................#............X......X......................................"
    ],
    [
        ".......#........#........X..X..........X.....#X...X#.......#........................X......X..............#..................#...#"
    ],
    [
        ".....................#...X..X..........X......X...X....#................#...#.......X......X#.....#.#..........................#.."
    ],
    [
        ".....#...................X..X..........X......X.#.X....................#............X##....XXXXXXXXXXXXXXXXXXXXXXXXXX#........#..."
    ],
    [
        ".....#......#............X..X.........#X......X...X..............#.....XXXXXXXXXXXXXXXXXXXXXXXXXXXXXXXXXXXXXXXXXXXXXXXXXXXXX#..#.."
    ],
    [
        ".#......#.............#..X..X#.........X......X...X....................X.......#....X#.....XX............##......#..X......X......"
    ],
    [
        "......................XXXXXXXXXXXXXXXXXXXXXXXXXXXXXXXXXXXXXXXXXXXXXXXXXXXXXXX##.....X......XX.......................X......X......"
    ],
    [
        "......................X..X..X..........X#.....X...X....................X....X...#...X....#.XX.......................X..#.#.X.....#"
    ],
    [
        "...........#..........X..X..X..........X......X..#X....................X....X..#....X.#....XX#..#...................X#..#..X......"
    ],
    [
        "......................X..X..X..........X.....#X...X..................#.X....X.......X...##.XX.#.....#...............X......X......"
    ],
    [
        "......................X.#XXXXXXXXXXXXXXXXXXXXXXXXXX....................X....X.......X..#...XX.......................X......X......"
    ],
    [
        "#..............#......X.....X..........X.#....X...#...#...............#X....X.......X#.....XX...........#...........X......X.##..."
    ],
    [
        "...#...#..............X.....X........#.X.....#XXXXXXXXXXXXXXXXXXXXXXXXXXXXXXXXXXXXXXXXXXXXXXX.#.....................X..#...X#....."
    ],
    [
        ".....#................X.....X..#..#....X..................#..........#.X....X.......X......#X.................#.#...X.#....X......"
    ],
    [
        "..................#...X....#X.#.......#XXXXXXXXXXXXXXXXXXXXXXXXXXXXXXXXXXXXXXXXXXXXXXXXXXXXXXXXXXXXXXXXXXXXXXXXXXXXXX.....#X...#.."
    ],
    [
        "..#...#...............X.....X.........................#.#..#...........X....X.......X.......X.......................#....#.X....#."
    ],
    [
        "...............#......X.....X..#..........................#............X....X.......X..#....X.....#.............#..........X......"
    ],
    [
        "............#.....#...X....#XXXXXXXXXXXXXXXXXXXXXXXXXXXXXXXXXXXXXXXXXXXXXXXXX.......X#......X.#........#.....#........#....X.#...."
    ],
    [
        "......................X.....#.........#....#........#.....#...#........X....#.......X.......X.................#............X......"
    ],
    [
        "........#.............X....#....#..........XXXXXXXXXXXXXXXXXXXXXXXXXXXXXXXXXXXXXXXXXXXXXXXX#X#.#...........................X......"
    ],
    [
        "......................X.........XXXXXXXXXXXXXXXXXXXXXXXXXXXXXXXXXXXXXXXXXXXXXXXXXXXXXXXXXXXXXXXXXXXXXXXXXXXXXXXXXXXX#......X......"
    ],
    [
        "#............#........X....#....X..........X..#........................X............X.....X.X......................X.#.....X......"
    ],
    [
        "......................X........#X...#......X...#...........##..........X............X.....X.X......................X.#.....X...#.#"
    ],
    [
        "................#.....X.........X..........X..............#.XXXXXXXXXXXXXXXXXXXXXXXXXXXXXXXXXXXXXXXXXXXXXXXX#......X.#.....X......"
    ],
    [
        "......................X.........X..........X..#............#X..........X....#.......X#....X.X..............X..#....X.......X......"
    ],
    [
        "..................#...X.....#...X..........X...........#....X........#.X............X#....X.X.....#........X.......X...#...X......"
    ],
    [
        "......................X.#...#...X..........X................X..........X....#.......X.....X#X....#.........X.......X...#...X......"
    ],
    [
        "...........#..........X.........X..........X.......#........X..........X..........#.X.....X.X........#....#X..##...X.......X......"
    ],
    [
        "#...............#.....X.........X..#.......X................X......#...X............X.....X.X......#.......X...XXXXXXXXXX#.X......"
    ],
    [
        ".............#........X.........X..XXXXXXXXXXXXXXXXXXXXXXXXXXXXXXXXXXXXXXXXXX##.....X.....X.X..............X...X...X....X..X......"
    ],
    [
        ".................#....X........#X..X.......X...........#...#X..........X#.#.X..#....X.....X.X..............X...X#..X....X..X#....."
    ],
    [
        "#......#......#.......X.........X..X.......X.....##....XXXXXXXXXXXXX#.#XXXXXX.......X.....X.X.........#....X...X...X....X..X......"
    ],
    [
        ".#...............#....X.....#...X..X.......X......XXXXXXXXXXXXXXXXXXXXXXXXXX#...#...X.....X#X.........#....X...X...X....X..X......"
    ],
    [
        "......................X.........X..X.#.....X......X....X....X.....#X...#...X....XXXXXXXXXXXXXXXXXXXXXXXXXXXXXXXXXXXXX#..X#.X......"
    ],
    [
        "......#...#...........X.#.#.....X..X.......X...#..X....X.#..X......X##.XXXXXXXXXXXXXXXXXXXXXXXXXXXXXXXX#...X...X..#XX...X..X.#...."
    ],
    [
        "......................X......#..X..X.......X....#.X..#.X....X......X##.X...X....X...X.....X.X#.#.....#X....X..#XXXXXXXXXXXXX......"
    ],
    [
        "......................X.........X..X.......X.....#X#...X....X......XXXXXXXXXXXXXXXXXXXXXXXXXXXXXXXXXXXXXXX#X.......XX...X..#......"
    ],
    [
        "......................X.........X..X..#....X......X....X....X......XX..X...X....X#..X...#.X.X.........X..X.X.......XX...X........."
    ],
    [
        "#....................#XXXXXXXXXXXXXXXXXXXXXXXXXXXXXXXXXXXXXXXXXXXXXXX..X...X....X#..X.....X.X.......#.X..X.X.......XX...X........."
    ],
    [
        ".....#.........#................X..X.......X......X....X....X......#X..X#.#X...#X#..X.....X#X.........X..X.X.......XX...X........."
    ],
    [
        "........#..........#......#.....X..X....#..X......X....X....X.......X..X.#.X...#X...X.....X.X...#.....X..X.X.......XX...X........."
    ],
    [
        "...........#....................X..X.......X#.....X....X#...X......#X..X..#X....X...X...#.X.X.........X..X.X.....#.XX...X........."
    ],
    [
        ".......#...............#........X..X.......X#..#..X....X....X......XXXXXXXXXXXXXXXXXXXXXXXXXXXXX#.....X..X.X.......XX...X........."
    ],
    [
        ".....................#.........#X.#X.......X...#..X....X..#.X......XX.#X...X....X.#.X.....X.X..X......X..X.X......#XX...X........."
    ],
    [
        "................#...#........#..X..X.....#.X......X....X....X......XX..X...X....X.XXXXXXXXXXXXXXXXXX#.X#.X.X.......XX...X..#......"
    ],
    [
        "....................XXXXXXXXXXXXXXXXXXXXXXXXXXXXXXXXXXXXX#..X......XX..X...X...#X.X#X.....X.X..X...X..X..X#X#......XX...X........#"
    ],
    [
        "................#...X..#....#.#.X..X.......X.#....X....XX.#.X......XX..X...X....X.X.X.....X.X..X...X..X..X.X.......XX...X........."
    ],
    [
        "..........#.........X...........X..X.......X....#.X....XX...X......XX..X...X....X.X.X.....X.X..X...X..X..X.X.......XX..#X........."
    ],
    [
        "#...................X...........X..X...#...X...#..X..##XX#..X......XX..X...X...#X.X.X....#X.X..X.#.X..X..X.X.......XX...X........."
    ],
    [
        "........#...#.......X......#....X..X.......X....#.X....XX...X......XX..X...X....X#X.X.....X.X..X...X..X..X.X.......XX...X.......#."
    ],
    [
        ".##.........XXXXXXXXXXXXXXXXXXXXXXXXXXXXXXXXXXXXXXXXXXXXXXXXXXXXXXXXXXXXXXXXXXX#X.X.X.#...X.X..X...X..X..X.X.......XX..#X........."
    ],
    [
        ".#..........X.......X.....#.....X..X.....#.X......X....XX...X......XX..X...X..X.X.X.X...#.X.X..X.#.X..X#.X.X...#...XX...X........."
    ],
    [
        "#...........X.......X...........X..X...#...X......X....XX...X#.....XX..X...X..X.X.X.X.....X.X..X...X..X..X.X.......XX...X........#"
    ],
    [
        "............X.......X.......#...X.#X....#..X......X..#.XX...X......XX#.X.#.X..X.X#X.X.....X#XXXXXXXXXXXXXXXXXXXXXXXXX...X........."
    ],
    [
        ".#..........X.......X......#....X..X.......X......X#...XX...X#.....XX#.X...X..X.X.X.X..#..X....X...X..X..X.X.......X#..#X........."
    ],
    [
        "............X.......X...........X..X.......X......X....XX...X......XX..X...X..X.X.X.X.....X....X...X..X..X.X.#.....X..##X........."
    ],
    [
        "...........#X..#...#X#..........X..X..#....X......X....XX...X......XX..X...X#.X.X.X.X#....X....X...X..X..X.X.......X....X........."
    ],
    [
        "......#.....X.......X.........#.X..X.....#.X.....#X....XX...X......XX..X...XXXXXXXXXXXXXXXXXXXXXXXXXXXXXXXXXXXXXXX#X....X........."
    ],
    [
        "........#...X#......X.#.........X..X.....#.X..##..X..#.XX...X.....#XX..X...XX.X.X.X.X.....X....X.#.X..X..X.X.#...X.X....X#..#....."
    ],
    [
        "............X.......X...........X.#XXXXXXXXXXXXXXXXXXXXXXXXXXXXXXXXXXXXXXXXXXXXXXXXXX.....X....X...X..X..X.X.....X#X....X........."
    ],
    [
        "............X.......X#.#........X..........X...#..X....XX...X......XX..X...XX.X.X.X.#.....X....X...X..X..X.X.....X.X....X........."
    ],
    [
        "............X.......X..XXXXXXXXXXXXXXXXXXXXXXXXXXXXXXXXXXXXXXXXXXXXXXXXXXXXXXXXXXXXXXXXX#.X....X..#X..X..X.X.....X.X#...X.....#..."
    ],
    [
        "............X.......X..X..#.....X....#....#X......X....XX...X......XX..X...XX.X.X.X..#.X..X....X...X..X..X.X.#...X.X....X.#.#....."
    ],
    [
        "............X.......X..X........X..........X...#.#X...#XX...X......XX..X...XX.X.X.X...#X..X....X...X..X..X#X.....X.X....X........#"
    ],
    [
        ".....#......X....#..X..X..#.#...X...#......X......X....XX...X.....#XX..X...XX.X.X.X..#.X..X....X...X..X..X.X.....X.X....X........."
    ],
    [
        "............X..#....X..X........X..........X......X....XX...X......XX..X.#.XX.X.X.X....X..X...#X...X..X..X.X....#X.X....X.....#..."
    ],
    [
        "#...........X.......X..X........X....##....X.....#XXXXXXXXXXXXXXXXXXXXXXXXXXXXXXXXXXXXXXXXXXXXXXXXXXXXXXXXXX.....X#X....X........."
    ],
    [
        "............X..#....X..X........X#...#.....X........#..XX...X......XX..X...XX.X.X.X....X..X....X...X..X..X.#.....X.X....X.#......."
    ],
    [
        "............X......#X..X..#.....X..........X...........XX...X......XX..X#..XX.X.X.X....X..X....X...X..X..X.......X.X....X......#.#"
    ],
    [
        "..#.........X...#...X..X#......#X...#..#..#XXXXXXXXXXXXXXXXXXXXXXXXXXXXXXXXXXXXXXXXXXXXXXXXXXXXXXXXXXXXXXXXXXXXXXXXX....X........."
    ],
    [
        ".........#..X.......X..X........X......................XX...X.#....XX..X...XX.X.X.X....X..X....X...X#.X..X.......X.#....X........."
    ],
    [
        "............X.#.....X..X.....#..X......................XX...X.XXXXXXXXXXXXXXXXXXXXXXXXXXXXXXXX#X...X..X..X.......X....#.X........."
    ],
    [
        "............X.......X..X..#.....X...........#..........XX...X.X....XX..X...XX.X.X.X....X..X..X.X...X##X..X.......X......X#.#......"
    ],
    [
        "............X..#..#.X..X........X......................XX...X.X....XX..X...XX.X.X.X....X..X..X.X...X..X..X.......X....#.X.....###."
    ],
    [
        "...#........X.......X..X.#..#...X....#..........#......XX...X.X....XX..X...XX.X.X.X....X..X..X.X...X..X..X.......X.##...X........."
    ],
    [
        "............X....#..X..X........X......................XX###X.X....XX..X..#XX.X.X.X....X..X..X.X...X#.X..X.......X......X........."
    ],
    [
        "...#........X.......X..X........X......................XX#..X.X..#.XX..X...XX.X.X.X....X..X.#X.X...X..X..X...#..#X......X........."
    ],
    [
        "............X.......X..X........X..................#...XX...X.X....XX.#X...XX.X.X.X....X..X..X.X...X..X..X.......X......X.......#."
    ],
    [
        ".....#......X......#X..X........X......#...............XX..#X.X....XX..X...XX.X.X.X....X..X..X.X.#.X..X..X.......X......X........."
    ],
    [
        "............X.......X#.X........X..............#......#XXXXXXXXXXXXXXXXXXXXXXXXXXXXXXXXXXXXXXXXX...X..X..X.......X......X........."
    ],
    [
        "...........#X.......X..X...#....X.#.....##...#...#......X...X.X....XX..X...XX.X.X.X....X..X..X.#...X..X.#X#......X......X.#...#..."
    ],
    [
        "............X.#.....X..X.....##.X.........#.............X...X.X...#XX#.X...XX.X.X.X....X..X..X.....X..X..X.......X......X........."
    ],
    [
        "............X......#XXXXXXXXXXXXXXXXXXXXXXXXXXXXXXXXXXXXXXXXXXXXXXXXXXXXXXXXX.X.X.X....X..X..X.....X..X..X.......X......X........."
    ],
    [
        "............X.....#....X..#.....X....#.......#..........X...X.X.#..XX......#X.X.X.X....X..X..X.....X..X..X.....#.X......X........."
    ],
    [
        "............X..........X........X.......................X...X.X....XX.......X.X.X.X....X..X..X#....X..X..X.......X......X........#"
    ],
    [
        "............X..........X........X.....................#.X...X.X....XX..#....X.X.X.X....X..X..X#....X..X..X.......X......X........."
    ],
    [
        "............X.#........X#.......X......................#X...X.X....XX.......X#X.X.X....X..X..X.....X#.X..X.......X......X........."
    ],
    [
        "#...........X....#.....X...#....X...........#...........X...X.X....XX.....#.X.X.X.X....X..X..X...#.X#.X.#X.......X.....#X........."
    ],
    [
        ".#..#.......X#.........X......#.X.............#.........X...X.X..#.XX.....#.X.X.X.X....X..X..X..#..X..X..X...#...X....#.X........."
    ],
    [
        "............X..........X........X....................#.#X...X.X..#.XX.......X.X.X.X....X#.X..X.....X..X..X.......X....#.X......#.."
    ],
    [
        "............X.........#X........X...........#..#......#.X...X.X....XX.......X.X.X#X....X..X..X.....X..X..X....#..X...#..X........."
    ],
    [
        "............X.........#X........X...............#..#....X...X.X....XX.......X.X.X.X...#X..X..X.....X..X..X....#..X......X....#...."
    ],
    [
        "............X..........X..#.....X............#..........X..#XXXXXXXXXXXXXXXXXXXXXXXXXXXXXXXXXXXXXXXXXXX..X.......X#.....X........."
    ],
    [
        "............X..........X..#....#XXXXXXXXXXXXXXXXXXXXXXXXX.....X....XX...#..#X.X#X.X.#..X..X..X.....X..#..X.......X......X........."
    ],
    [
        ".......#....X......#...X...................#............##....X...#XXXXXXXXXXXXXXXXXXXXX..X..X.....X.....X.......X.....#X........."
    ],
    [
        "#...........X..........X................................XXXXXXXXXXXXXXXXXXX#XXX.X.X....#..X..X.....X.....X.......X......X........."
    ],
    [
        "............X..........X................................X...#.X.....X.....X...#.X#XXXXXXXXXXXXXXXXXXXXXXXX.......X......X.##......"
    ],
    [
        "..#.........X..........X..........................#....#XXXXXXXXXXXXXXXXXXXXXXXXXXXXXXXXXXXXXXXXXXXX.....##.....#X..##..X..#......"
    ],
    [
        "...#.....##.X..........X.................#....................X.....X.....X.....X.........X..X.....#............#X......X........."
    ],
    [
        ".....#....##X..........X................#....##..........#...#XXXXXXXXXXXXXXXXXXXXXXXXXXXXXXXXXXXXXXXXXXXXXXXXXXXXXXXXXXX........."
    ],
    [
        "............X..........X..........................#.................X.....X..#..X......##.X..X..#................X......#........."
    ],
    [
        ".........#..X..#.......X..#........#........................#.##..#.X.....X....#XXXXXXXXXXXXXXXXXXXXXXXXXXXXXXXXXX.....#.........."
    ],
    [
        ".....#......X........#.X.....#..........#.#..........#..............X.....X#..............X..X...................#.....#.........."
    ],
    [
        "....#......#XXXXXXXXXXXXXXXXXXXXXXXXXXXXXXXXXXXXXXXXXXXXXXXXXXXXXXXXXXXXXXXXXXXXXXXXXXXXXXXXXX..........##...#.#.#.........#......"
    ],
    [
        "...........#...........X............#.....#....................#....X.....X.......#.#.....X..#...................................."
    ],
    [
        ".......................X............................#...............X#.#..X...............X.............................#........."
    ],
    [
        "..........#............X.#.......................#.................#XXXXXXXXXXXXXXXXXXXXXXX............#.............#.#......##.."
    ],
    [
        "................##.....X................................................#.X...............#.......#.#....................#........"
    ],
    [
        "................#......X...............................................#..X..........##...............#.....#......#.......#......"
    ],
    [
        ".......................X......#............................#..........#...X.......#..............................................."
    ],
    [
        ".......#.............#.X..................................................X...............#..............................#.#......"
    ],
    [
        "...#...................X.#.#..............................................X................#...#..#....#.........................."
    ],
    [
        "....#.........##......#XXXXXXXXXXXXXXXXXXXXXXXXXXXXXXXXXXXXXXXXXXXXXXXXXXXX..........................#..................#........."
    ],
    [
        "....#..........................................#......#...................#........##............#................................"
    ],
    [
        "..#.......#......#............#........#...#.#...........................#.......#................................................"
    ],
    [
        "..........................#...#....................#...............#...#......#.#...#...#...............#.#.#....................."
    ],
    [
        "....##.#....................................................................#...#.....##........................#.##.............."
    ],
    [
        ".............................................#...................................................................................."
    ]
]