[
    [
        "...#..................#...................#......................#..............................#.............................#..."
    ],
    [
        "....#.......................#........#.#..............##...........#.....#..........#..........................#.................."
    ],
    [
        ".............#........................................................................#.........#.#..#..#..........#.............."
    ],
    [
        "..........#.......#..........#..................#........##...................#..............#...................................."
    ],
    [
        "....................#..........................................................#..#.....................................#........."
    ],
    [
        "....#............................#..............................................#.....................#..........##....#.........."
    ],
    [
        ".......#.............#......................................................................#.............#.........#............."
    ],
    [
        "....###......................#....#...........#.....#................................#..........................#................."
    ],
    [
        "..........#..#...........#..#........................................................#.....#...........#................#........."
    ],
    [
        "..#....#......#....#....#...................................................................#....................................."
    ],
    [
        "....................#............#............................................#......#....#...............................#......."
    ],
    [
        "..........#.......#.........#.......#............................................................................................."
    ],
    [
        ".......#...#.......................................#...................#.........................................................."
    ],
    [
        ".......#........#............................#.....#.......#..............................................#..................#...#"
    ],
    [
        ".....................#.................................#................#...#...............#.....#.#..........................#.."
    ],
    [
        ".....#..........................................#......................#.............##..............................#........#..."
    ],
    [
        ".....#......#.........................#..........................#..........................................................#..#.."
    ],
    [
        ".#......#.............#......#.................................................#.....#...................##......#................"
    ],
    [
        ".............................................................................##..................................................."
    ],
    [
        "........................................#.......................................#........#.............................#.#.......#"
    ],
    [
        "...........#.....................................#.............................#......#......#..#....................#..#........."
    ],
    [
        ".............................................#.......................#..................##....#.....#............................."
    ],
    [
        "........................#..............................................................#.........................................."
    ],
    [
        "#..............#.........................#........#...#...............#..............#..................#....................##..."
    ],
    [
        "...#...#.............................#.......#................................................#........................#....#....."
    ],
    [
        ".....#.........................#..#.......................#..........#.....................#..................#.#.....#..........."
    ],
    [
        "..................#........#..#.......#...................................................................................#....#.."
    ],
    [
        "..#...#...............................................#.#..#........................................................#....#......#."
    ],
    [
        "...............#...............#..........................#............................#..........#.............#................."
    ],
    [
        "............#.....#........#.........................................................#........#........#.....#........#......#...."
    ],
    [
        "............................#.........#....#........#.....#...#.............#.................................#..................."
    ],
    [
        "........#..................#....#..........XXXXXXXXXXXXXXXXXXXXXXXXXXXXXXXXXXXXXXXXXXXXXXXX#.#.#.................................."
    ],
    [
        "................................XXXXXXXXXXXXXXXXXXXXXXXXXXXXXXXXXXXXXXXXXXXXXXXXXXXXXXXXXXXXXXXXXXXXXXXXXXXXXXXXXXXX#............."
    ],
    [
        "#............#.............#....X..........X..#...........................................X........................X.#............"
    ],
    [
        "...............................#X...#......X...#...........##.............................X........................X.#.........#.#"
    ],
    [
        "................#...............X..........X..............#.XXXXXXXXXXXXXXXXXXXXXXXXXXXXXXXXXXXXXXXXXXXXXXXX#......X.#............"
    ],
    [
        "................................X..........X..#............#X...............#........#....X................X..#....X.............."
    ],
    [
        "..................#.........#...X..........X...........#....X........#...............#....X.......#........X.......X...#.........."
    ],
    [
        "........................#...#...X..........X................X...............#.............X#.....#.........X.......X...#.........."
    ],
    [
        "...........#....................X..........X.......#........X.....................#.......X..........#....#X..##...X.............."
    ],
    [
        "#...............#...............X..#.......X................X......#......................X........#.......X.......X.....#........"
    ],
    [
        ".............#..................X..........X................X................##...........X................X.......X.............."
    ],
    [
        ".................#.............#X..........X...........#...#X...........#.#....#..........X................X....#..X........#....."
    ],
    [
        "#......#......#.................X..........X.....##.........X.......#.#...................X...........#....X.......X.............."
    ],
    [
        ".#...............#..........#...X..........X......XXXXXXXXXXXXXXXXXXXXXXXXXX#...#.........X#..........#....X.......X.............."
    ],
    [
        "................................X....#.....X......X.........X.....#....#...X..............X................X.......X.#...#........"
    ],
    [
        "......#...#.............#.#.....X..........X...#..X......#..X.......##.XXXXXXXXXXXXXXXXXXXXXXXXXXXXXXXX#...X......#X.........#...."
    ],
    [
        ".............................#..X..........X....#.X..#......X.......##.X...X..............X..#.#.....#X....X..#....X.............."
    ],
    [
        "................................X..........X.....#X#........X.......XXXXXXXXXXXXXXXXXXXXXXXXXXXXXXXXXXXXXX#X.......X.......#......"
    ],
    [
        "................................X.....#....X......X.........X.......X..X...X.....#......#.X...........X..X.X.......X.............."
    ],
    [
        "#....................#..........X..........X......X.........X.......X..X...X.....#........X.........#.X..X.X.......X.............."
    ],
    [
        ".....#.........#................X..........X......X.........X......#X..X#.#X...#.#........X#..........X..X.X.......X.............."
    ],
    [
        "........#..........#......#.....X.......#..X......X.........X.......X..X.#.X...#..........X.....#.....X..X.X.......X.............."
    ],
    [
        "...........#....................X..........X#.....X.....#...X......#X..X..#X............#.X...........X..X.X.....#.X.............."
    ],
    [
        ".......#...............#........X..........X#..#..X.........X......XXXXXXXXXXXXXXXXXXXXXXXXXXXXX#.....X..X.X.......X.............."
    ],
    [
        ".....................#.........#X.#........X...#..X.......#.X......XX.#X...X......#.......X....X......X..X.X......#X.............."
    ],
    [
        "................#...#........#..X........#.X......X.........X......XX..X...X......XXXXXXXXXXXXXXXXXX#.X#.X.X.......X.......#......"
    ],
    [
        "....................XXXXXXXXXXXXXXXXXXXXXXXXXXXXXXXXXXXXX#..X......XX..X...X...#..X#......X....X...X..X..X#X#......X.............#"
    ],
    [
        "................#...X..#....#.#.X..........X.#....X.....X.#.X......XX..X...X......X.......X....X...X..X..X.X.......X.............."
    ],
    [
        "..........#.........X...........X..........X....#.X.....X...X......XX..X...X......X.......X....X...X..X..X.X.......X...#.........."
    ],
    [
        "#...................X...........X......#...X...#..X..##.X#..X......XX..X...X...#..X......#X....X.#.X..X..X.X.......X.............."
    ],
    [
        "........#...#.......X......#....X..........X....#.X.....X...X......XX..X...X.....#X.......X....X...X..X..X.X.......X............#."
    ],
    [
        ".##.................X...........X..........X......X.....X...X......XX..X...X...#..X...#...X....X...X..X..X.X.......X...#.........."
    ],
    [
        ".#..................X.....#.....X........#.X......X.....X...X......XX..X...X......X.....#.X....X.#.X..X#.X.X...#...X.............."
    ],
    [
        "#...................X...........X......#...X......X.....X...X#.....XX..X...X......X.......X....X...X..X..X.X.......X.............#"
    ],
    [
        "....................X.......#...X.#.....#..X......X..#..X...X......XX#.X.#.X.....#X.......X#...X...X..X..X.X.......X.............."
    ],
    [
        ".#..................X......#....X..........X......X#....X...X#.....XX#.X...X......X....#..X....v...X..X..X.X.......X#..#.........."
    ],
    [
        "....................X...........X..........X......X.....X...X......XX..X...X......X.......X....#...X..X..X.X.#.....X..##.........."
    ],
    [
        "...........#...#...#X#..........X.....#....X......X.....X...X......XX..X...X#.....X..#....X........X..X..X.X.......X.............."
    ],
    [
        "......#.............X.........#.X........#.X.....#X.....X...X......XX..X...X......X.......X........X..X..X.X......#X.............."
    ],
    [
        "........#....#......X.#.........X........#.X..##..X..#..X...X.....#XX..X...X......X.......X......#.X..X..X.X.#.....X.....#..#....."
    ],
    [
        "....................X...........X.#........X......X.....X...X......XX..X...X......X.......X........X..X..X.X......#X.............."
    ],
    [
        "....................X#.#........X..........X...#..X.....X...X......XX..X...X......X.#.....X........X..X..X.X.......X.............."
    ],
    [
        "....................X..XXXXXXXXXXXXXXXXXXXXXXXXXXXXXXXXXXXXXXXXXXXXXXXXXXXXXXXXXXXXXXXXX#.X.......#X..X..X.X.......X#.........#..."
    ],
    [
        "....................X..X..#.....X....#....#X......X.....X...X......XX..X...X......X..#.X..X........X..X..X.X.#.....X......#.#....."
    ],
    [
        "....................X..X........X..........X...#.#X...#.X...X......XX..X...X......X...#X..X........X..X..X#X.......X.............#"
    ],
    [
        ".....#...........#..X..X..#.#...X...#......X......X.....X...X.....#XX..X...X......X..#.X..X........X..X..X.X.......X.............."
    ],
    [
        "...............#....X..X........X..........X......X.....X...X......XX..X.#.X......X....X..X...#....X..X..X.X....#..X..........#..."
    ],
    [
        "#...................X..X........X....##....X.....#XXXXXXXXXXXXXXXXXXXXXXXXXXXXXXXXXXXXXXXXXXXXXXXXXXXXXXXXXX......#X.............."
    ],
    [
        "...............#....X..X........X#...#.....X........#...X...X......XX..X...X......X....X..X........X..X..X.#.......X......#......."
    ],
    [
        "...................#X..X..#.....X..........X............X...X......XX..X#..X......X....X..X........X..X..X.........X...........#.#"
    ],
    [
        "..#.............#...X..X#......#X...#..#..#XXXXXXXXXXXXXXXXXXXXXXXXXXXXXXXXXXXXXXXXXXXXXXXXXXXXXXXXXXXXXXXXXXXXXXXXX.............."
    ],
    [
        ".........#..........X..X........X.......................X...X.#....XX..X...X......X....X..X........X#.X..X.........#.............."
    ],
    [
        "..............#.....X..X.....#..X.......................X...X......XX..X...X......X....X..X...#....X..X..X............#..........."
    ],
    [
        "....................X..X..#.....X...........#...........X...X......XX..X...X......X....X..X........X##X..X...............#.#......"
    ],
    [
        "...............#..#.X..X........X.......................X...X......XX..X...X......X....X..X........X..X..X............#.......###."
    ],
    [
        "...#................X..X.#..#...X....#..........#.......X...X......XX..X...X......X....X..X........X..X..X.........##............."
    ],
    [
        ".................#..X..X........X.......................X###X......XX..X..#X......X....X..X........X#.X..X........................"
    ],
    [
        "...#................X..X........X.......................X#..X....#.XX..X...X......X....X..X.#......X..X..X...#..#................."
    ],
    [
        "....................X..X........X..................#....X...X......XX.#X...X......X....X..X........X..X..X......................#."
    ],
    [
        ".....#.............#X..X........X......#................X..#X......XX..X...X......X....X..X......#.X..X..X........................"
    ],
    [
        "....................X#.X........X..............#......#.X...X......XX..X...X......X....X..X........X..X..X........................"
    ],
    [
        "...........#........X..X...#....X.#.....##...#...#......X...X......XX..X...X......X....X..X....#...X..X.#X#...............#...#..."
    ],
    [
        "..............#.....X..X.....##.X.........#.............X...X.....#XX#.X...X......X....X..X........X..X..X........................"
    ],
    [
        "...................#XXXXXXXXXXXXXXXXXXXXXXXXXXXXXXXXXXXXXXXXXXXXXXXXXXXXXXXX......X....X..X........X..X..X........................"
    ],
    [
        "..................#....X..#.....X....#.......#..........X...X...#..XX......#......X....X..X........X..X..X.....#.................."
    ],
    [
        ".......................X........X.......................X...X......XX.............X....X..X...#....X..X..X.......................#"
    ],
    [
        ".......................X........X.....................#.X...X......XX..#..........X....X..X...#....X..X..X........................"
    ],
    [
        "..............#........X#.......X......................#X...X......XX........#....X....X..X........X#.X..X........................"
    ],
    [
        "#................#.....X...#....X...........#...........X...X......XX.....#.......X....X..X......#.X#.X.#X.............#.........."
    ],
    [
        ".#..#........#.........X......#.X.............#.........X...X....#.XX.....#.......X....X..X.....#..X..X..X...#........#..........."
    ],
    [
        ".......................X........X....................#.#X...X....#.XX.............X....X#.X........X..X..X............#........#.."
    ],
    [
        "......................#X........X...........#..#......#.X...X......XX............#X....X..X........X..X..X....#......#............"
    ],
    [
        "......................#X........X...............#..#....X...X......XX.............X...#X..X........X..X..X....#..............#...."
    ],
    [
        ".......................X..#.....X............#..........X..#XXXXXXXXXXXXXXXXXXXXXXXXXXXXXXXXXXXXXXXXXXX..X........#..............."
    ],
    [
        ".......................X..#....#XXXXXXXXXXXXXXXXXXXXXXXXX..........XX...#..#...#..X.#..X..X........X..#..X........................"
    ],
    [
        ".......#...........#...X...................#............##........#XXXXXXXXXXXXXXXXXXXXX..X........X.....X.............#.........."
    ],
    [
        "#......................X................................XXXXXXXXXXXXXXXXXXX#......X....#..X........X.....X........................"
    ],
    [
        ".......................X................................X...#.......X.....X...#..#XXXXXXXXXXXXXXXXXXXXXXXX................##......"
    ],
    [
        "..#....................X..........................#....#XXXXXXXXXXXXXXXXXXXXXXXXXXXXXXXXXXXXXXXXXXXX.....##.....#...##.....#......"
    ],
    [
        "...#.....##............X.................#..........................X.....X...............X........#............#................."
    ],
    [
        ".....#....##...........X................#....##..........#...#......X.....X...............X......................................."
    ],
    [
        ".......................X..........................#.................X.....X..#.........##.X.....#.......................#........."
    ],
    [
        ".........#.....#.......X..#........#........................#.##..#.X.....X....#..........X............................#.........."
    ],
    [
        ".....#...............#.X.....#..........#.#..........#..............X.....X#..............X......................#.....#.........."
    ],
    [
        "....#......#...........X............................................X.....X...............X.............##...#.#.#.........#......"
    ],
    [
        "...........#...........X............#.....#....................#....X.....X.......#.#.....X..#...................................."
    ],
    [
        ".......................X............................#...............X#.#..X...............X.............................#........."
    ],
    [
        "..........#............X.#.......................#.................#XXXXXXXXXXXXXXXXXXXXXXX............#.............#.#......##.."
    ],
    [
        "................##.....X................................................#.X...............#.......#.#....................#........"
    ],
    [
        "................#......X...............................................#..X..........##...............#.....#......#.......#......"
    ],
    [
        ".......................X......#............................#..........#...X.......#..............................................."
    ],
    [
        ".......#.............#.X..................................................X...............#..............................#.#......"
    ],
    [
        "...#...................X.#.#..............................................X................#...#..#....#.........................."
    ],
    [
        "....#.........##......#XXXXXXXXXXXXXXXXXXXXXXXXXXXXXXXXXXXXXXXXXXXXXXXXXXXX..........................#..................#........."
    ],
    [
        "....#..........................................#......#...................#........##............#................................"
    ],
    [
        "..#.......#......#............#........#...#.#...........................#.......#................................................"
    ],
    [
        "..........................#...#....................#...............#...#......#.#...#...#...............#.#.#....................."
    ],
    [
        "....##.#....................................................................#...#.....##........................#.##.............."
    ],
    [
        ".............................................#...................................................................................."
    ]
]