[
    [
        "...#..................#...................#......................#..............................#.............................#..."
    ],
    [
        "....#.......................#........#.#..............##...........#.....#..........#..........................#.................."
    ],
    [
        ".............#........................................................................#.........#.#..#..#..........#.............."
    ],
    [
        "..........#.......#..........#..................#........##...................#..............#...................................."
    ],
    [
        "....................#..........................................................#..#.....................................#........."
    ],
    [
        "....#............................#..............................................#.....................#..........##....#.........."
    ],
    [
        ".......#.............#......................................................................#.............#.........#............."
    ],
    [
        "....###......................#....#...........#.....#................................#..........................#................."
    ],
    [
        "..........#..#...........#..#........................................................#.....#...........#................#........."
    ],
    [
        "..#....#......#....#....#...................................................................#....................................."
    ],
    [
        "....................#............#............................................#......#....#...............................#......."
    ],
    [
        "..........#.......#.........#.......#............................................................................................."
    ],
    [
        ".......#...#.......................................#...................#.........................................................."
    ],
    [
        ".......#........#............................#.....#.......#..............................................#..................#...#"
    ],
    [
        ".....................#.................................#................#...#...............#.....#.#..........................#.."
    ],
    [
        ".....#..........................................#......................#.............##..............................#........#..."
    ],
    [
        ".....#......#.........................#..........................#..........................................................#..#.."
    ],
    [
        ".#......#.............#......#.................................................#.....#...................##......#................"
    ],
    [
        ".............................................................................##..................................................."
    ],
    [
        "........................................#.......................................#........#.............................#.#.......#"
    ],
    [
        "...........#.....................................#.............................#......#......#..#....................#..#........."
    ],
    [
        ".............................................#.......................#..................##....#.....#............................."
    ],
    [
        "........................#..............................................................#.........................................."
    ],
    [
        "#..............#.........................#........#...#...............#..............#..................#....................##..."
    ],
    [
        "...#...#.............................#.......#................................................#........................#....#....."
    ],
    [
        ".....#.........................#..#.......................#..........#.....................#..................#.#.....#..........."
    ],
    [
        "..................#........#..#.......#...................................................................................#....#.."
    ],
    [
        "..#...#...............................................#.#..#........................................................#....#......#."
    ],
    [
        "...............#...............#..........................#............................#..........#.............#................."
    ],
    [
        "............#.....#........#.........................................................#........#........#.....#........#......#...."
    ],
    [
        "............................#.........#....#........#.....#...#.............#.................................#..................."
    ],
    [
        "........#..................#....#..........................................................#.#.#.................................."
    ],
    [
        "....................................................................................................................#............."
    ],
    [
        "#............#.............#..................#......................................................................#............"
    ],
    [
        "...............................#....#..........#...........##........................................................#.........#.#"
    ],
    [
        "................#.........................................#.................................................#........#............"
    ],
    [
        "..............................................#............#................#........#........................#..................."
    ],
    [
        "..................#.........#..........................#.............#...............#............#....................#.........."
    ],
    [
        "........................#...#...............................................#..............#.....#.....................#.........."
    ],
    [
        "...........#.......................................#..............................#..................#....#...##.................."
    ],
    [
        "#...............#..................#...............................#...............................#.....................#........"
    ],
    [
        ".............#...............................................................##..................................................."
    ],
    [
        ".................#.............#.......................#...#............#.#....#................................#...........#....."
    ],
    [
        "#......#......#..................................##.................#.#...............................#..........................."
    ],
    [
        ".#...............#..........#...............................................#...#..........#..........#..........................."
    ],
    [
        ".....................................#............................#....#.............................................#...#........"
    ],
    [
        "......#...#.............#.#....................#.........#..........##.XXXXXXXXXXXXXXXXXXXXXXXXXXXXXXXX#..........#..........#...."
    ],
    [
        ".............................#..................#....#..............##.X.....................#.#.....#X.......#..................."
    ],
    [
        ".................................................#.#...................X..............................X...#................#......"
    ],
    [
        "......................................#................................X.........#......#.............X..........................."
    ],
    [
        "#....................#.................................................X.........#..................#.X..........................."
    ],
    [
        ".....#.........#...................................................#...X#.#....#.#.........#..........X..........................."
    ],
    [
        "........#..........#......#.............#..............................X.#.....#................#.....X..........................."
    ],
    [
        "...........#................................#...........#..........#...X..#.............#.............X..........#................"
    ],
    [
        ".......#...............#....................#..#.......................X........................#.....X..........................."
    ],
    [
        ".....................#.........#..#............#..........#...........#X..........#...................X...........#..............."
    ],
    [
        "................#...#........#...........#.............................X............................#.X#...................#......"
    ],
    [
        ".........................................................#.............X.......#...#..................X...#.#....................#"
    ],
    [
        "................#......#....#.#..............#............#............X..............................X..........................."
    ],
    [
        "..........#.....................................#......................X..............................X................#.........."
    ],
    [
        "#......................................#.......#.....##..#.............X.......#.........#.......#....X..........................."
    ],
    [
        "........#...#..............#....................#......................X.........#....................X.........................#."
    ],
    [
        ".##....................................................................X.......#......#...............X................#.........."
    ],
    [
        ".#........................#..............#.............................X................#........#....X#.......#.................."
    ],
    [
        "#......................................#.....................#.........X..............................X..........................#"
    ],
    [
        "............................#.....#.....#............#...............#.X.#.......#.........#..........X..........................."
    ],
    [
        ".#.........................#.......................#.........#.......#.X...............#..............X.............#..#.........."
    ],
    [
        ".......................................................................X..............................X......#........##.........."
    ],
    [
        "...........#...#...#.#................#................................X....#........#................X..........................."
    ],
    [
        "......#.......................#..........#.......#.....................X..............................X...........#..............."
    ],
    [
        "........#....#........#..................#....##.....#............#....X.........................#....X......#...........#..#....."
    ],
    [
        "..................................#....................................X..............................X...........#..............."
    ],
    [
        ".....................#.#.......................#.......................X............#.................X..........................."
    ],
    [
        ".......................................................................X................#.........#...X.............#.........#..."
    ],
    [
        "..........................#..........#....#............................X.............#................X......#............#.#....."
    ],
    [
        "...............................................#.#....#................X..............#...............X...#......................#"
    ],
    [
        ".....#...........#........#.#.......#.............................#....X.............#................X..........................."
    ],
    [
        "...............#.......................................................X.#....................#.......X.........#.............#..."
    ],
    [
        "#....................................##..........#.....................X..............................X...........#..............."
    ],
    [
        "...............#.................#...#..............#..................X..............................X....#..............#......."
    ],
    [
        "...................#......#............................................X#.............................X........................#.#"
    ],
    [
        "..#.............#.......#......#....#..#..#............................X..............................X..........................."
    ],
    [
        ".........#....................................................#........X............................#.X............#.............."
    ],
    [
        "..............#..............#.........................................X......................#.......X...............#..........."
    ],
    [
        "..........................#.................#..........................X............................##X..................#.#......"
    ],
    [
        "...............#..#....................................................X..............................X...............#.......###."
    ],
    [
        "...#.....................#..#........#..........#......................X..............................X............##............."
    ],
    [
        ".................#.......................................###...........X..#.........................#.X..........................."
    ],
    [
        "...#.....................................................#.......#.....X....................#.........X......#..#................."
    ],
    [
        "...................................................#..................#X..............................X.........................#."
    ],
    [
        ".....#.............#...................#...................#...........X.........................#....X..........................."
    ],
    [
        ".....................#.........................#......#................X..............................X..........................."
    ],
    [
        "...........#...............#......#.....##...#...#.....................X.......................#......X.#.#...............#...#..."
    ],
    [
        "..............#..............##...........#.......................#..#.X..............................X..........................."
    ],
    [
        "...................#..................................................................................X..........................."
    ],
    [
        "..................#.......#..........#.......#..................#..........#..........................v........#.................."
    ],
    [
        "..............................................................................................#.......#..........................#"
    ],
    [
        "......................................................#................#......................#..................................."
    ],
    [
        "..............#.........#..............................#.....................#......................#............................."
    ],
    [
        "#................#.........#................#.............................#......................#..#...#..............#.........."
    ],
    [
        ".#..#........#................#...............#..................#........#.....................#............#........#..........."
    ],
    [
        ".....................................................#.#.........#......................#.............................#........#.."
    ],
    [
        "......................#.....................#..#......#..........................#............................#......#............"
    ],
    [
        "......................#.........................#..#..................................#.......................#..............#...."
    ],
    [
        "..........................#..................#.............#......................................................#..............."
    ],
    [
        "..........................#....#........................................#..#...#....#.................#..........................."
    ],
    [
        ".......#...........#.......................#............##........#....................................................#.........."
    ],
    [
        "#..........................................................................#...........#.........................................."
    ],
    [
        "............................................................#.................#..#........................................##......"
    ],
    [
        "..#...............................................#....#.................................................##.....#...##.....#......"
    ],
    [
        "...#.....##..............................#.........................................................#............#................."
    ],
    [
        ".....#....##............................#....##..........#...#...................................................................."
    ],
    [
        "..................................................#..........................#.........##.......#.......................#........."
    ],
    [
        ".........#.....#..........#........#........................#.##..#............#.......................................#.........."
    ],
    [
        ".....#...............#.......#..........#.#..........#.....................#.....................................#.....#.........."
    ],
    [
        "....#......#............................................................................................##...#.#.#.........#......"
    ],
    [
        "...........#........................#.....#....................#..................#.#........#...................................."
    ],
    [
        "....................................................#................#.#................................................#........."
    ],
    [
        "..........#..............#.......................#.................#...................................#.............#.#......##.."
    ],
    [
        "................##......................................................#.................#.......#.#....................#........"
    ],
    [
        "................#......................................................#.............##...............#.....#......#.......#......"
    ],
    [
        "..............................#............................#..........#...........#..............................................."
    ],
    [
        ".......#.............#....................................................................#..............................#.#......"
    ],
    [
        "...#.....................#.#...............................................................#...#..#....#.........................."
    ],
    [
        "....#.........##......#..............................................................................#..................#........."
    ],
    [
        "....#..........................................#......#...................#........##............#................................"
    ],
    [
        "..#.......#......#............#........#...#.#...........................#.......#................................................"
    ],
    [
        "..........................#...#....................#...............#...#......#.#...#...#...............#.#.#....................."
    ],
    [
        "....##.#....................................................................#...#.....##........................#.##.............."
    ],
    [
        ".............................................#...................................................................................."
    ]
]