[
    [
        "...#..................#...................#......................#..............................#.............................#..."
    ],
    [
        "....#.......................#........#.#..............##...........#.....#..........#..........................#.................."
    ],
    [
        ".............#........................................................................#.........#.#..#..#..........#.............."
    ],
    [
        "..........#.......#..........#..................#........##...................#..............#...................................."
    ],
    [
        "....................#..........................................................#..#.....................................#........."
    ],
    [
        "....#............................#..............................................#.....................#..........##....#.........."
    ],
    [
        ".......#.............#......................................................................#.............#.........#............."
    ],
    [
        "....###......................#....#...........#.....#................................#..........................#................."
    ],
    [
        "..........#..#...........#..#........................................................#.....#...........#................#........."
    ],
    [
        "..#....#......#....#....#...................................................................#....................................."
    ],
    [
        "....................#............#............................................#......#....#...............................#......."
    ],
    [
        "..........#.......#.........#.......#............................................................................................."
    ],
    [
        ".......#...#.......................................#...................#.........................................................."
    ],
    [
        ".......#........#............................#.....#.......#..............................................#..................#...#"
    ],
    [
        ".....................#.................................#................#...#...............#.....#.#..........................#.."
    ],
    [
        ".....#..........................................#......................#.............##..............................#........#..."
    ],
    [
        ".....#......#.........................#..........................#..........................................................#..#.."
    ],
    [
        ".#......#.............#......#.................................................#.....#...................##......#................"
    ],
    [
        ".............................................................................##..................................................."
    ],
    [
        "........................................#.......................................#........#.............................#.#.......#"
    ],
    [
        "...........#.....................................#.............................#......#......#..#....................#..#........."
    ],
    [
        ".............................................#.......................#..................##....#.....#............................."
    ],
    [
        "........................#..............................................................#.........................................."
    ],
    [
        "#..............#.........................#........#...#...............#..............#..................#....................##..."
    ],
    [
        "...#...#.............................#.......#................................................#........................#....#....."
    ],
    [
        ".....#.........................#..#.......................#..........#.....................#..................#.#.....#..........."
    ],
    [
        "..................#........#..#.......#...................................................................................#....#.."
    ],
    [
        "..#...#...............................................#.#..#........................................................#....#......#."
    ],
    [
        "...............#...............#..........................#............................#..........#.............#................."
    ],
    [
        "............#.....#........#.........................................................#........#........#.....#........#......#...."
    ],
    [
        "............................#.........#....#........#.....#...#.............#.................................#..................."
    ],
    [
        "........#..................#....#..........................................................#.#.#.................................."
    ],
    [
        "....................................................................................................................#............."
    ],
    [
        "#............#.............#..................#......................................................................#............"
    ],
    [
        "...............................#....#..........#...........##........................................................#.........#.#"
    ],
    [
        "................#.........................................#.XXXXXXXXXXXXXXXXXXXXXXXXXXXXXXXXXXXXXXXXXXXXXXXX#........#............"
    ],
    [
        "..............................................#............#X...............#........#.....................X..#..................."
    ],
    [
        "..................#.........#..........................#....X........#...............#............#........X...........#.........."
    ],
    [
        "........................#...#...............................X...............#..............#.....#.........X...........#.........."
    ],
    [
        "...........#.......................................#........X.....................#..................#....#X..##.................."
    ],
    [
        "#...............#..................#........................X......#...............................#.......X.............#........"
    ],
    [
        ".............#..............................................X................##............................X......................"
    ],
    [
        ".................#.............#.......................#...#X...........#.#....#...........................X....#...........#....."
    ],
    [
        "#......#......#..................................##.........X.......#.#...............................#....X......................"
    ],
    [
        ".#...............#..........#...............................X...............#...#..........#..........#....X......................"
    ],
    [
        ".....................................#......................X.....#....#...................................X.........#...#........"
    ],
    [
        "......#...#.............#.#....................#.........#..X.......##.XXXXXXXXXXXXXXXXXXXXXXXXXXXXXXXX#...X......#..........#...."
    ],
    [
        ".............................#..................#....#......X.......##.X.....................#.#.....#X....X..#..................."
    ],
    [
        ".................................................#.#........X..........X..............................X...#X...............#......"
    ],
    [
        "......................................#.....................X..........X.........#......#.............X....X......................"
    ],
    [
        "#....................#......................................X..........X.........#..................#.X....X......................"
    ],
    [
        ".....#.........#............................................X......#...X#.#....#.#.........#..........X....X......................"
    ],
    [
        "........#..........#......#.............#...................X..........X.#.....#................#.....X....X......................"
    ],
    [
        "...........#................................#...........#...X......#...X..#.............#.............X....X.....#................"
    ],
    [
        ".......#...............#....................#..#............X..........X........................#.....X....X......................"
    ],
    [
        ".....................#.........#..#............#..........#.X.........#X..........#...................X....X......#..............."
    ],
    [
        "................#...#........#...........#..................X..........X............................#.X#...X...............#......"
    ],
    [
        ".........................................................#..X..........X.......#...#..................X...#X#....................#"
    ],
    [
        "................#......#....#.#..............#............#.X..........X..............................X....X......................"
    ],
    [
        "..........#.....................................#...........X..........X..............................X....X...........#.........."
    ],
    [
        "#......................................#.......#.....##..#..X..........X.......#.........#.......#....X....X......................"
    ],
    [
        "........#...#..............#....................#...........X..........X.........#....................X....X....................#."
    ],
    [
        ".##.........................................................X..........X.......#......#...............X....X...........#.........."
    ],
    [
        ".#........................#..............#..................X..........X................#........#....X#...X...#.................."
    ],
    [
        "#......................................#....................X#.........X..............................X....X.....................#"
    ],
    [
        "............................#.....#.....#............#......X........#.X.#.......#.........#..........X....X......................"
    ],
    [
        ".#.........................#.......................#........X#.......#.X...............#..............X....X........#..#.........."
    ],
    [
        "............................................................X..........X..............................X....X.#........##.........."
    ],
    [
        "...........#...#...#.#................#.....................X..........X....#........#................X....X......................"
    ],
    [
        "......#.......................#..........#.......#..........X..........X..............................X....X......#..............."
    ],
    [
        "........#....#........#..................#....##.....#......X.....#....X.........................#....X....X.#...........#..#....."
    ],
    [
        "..................................#.........................X..........X..............................X....X......#..............."
    ],
    [
        ".....................#.#.......................#............X..........X............#.................X....X......................"
    ],
    [
        "............................................................X..........X................#.........#...X....X........#.........#..."
    ],
    [
        "..........................#..........#....#.................X..........X.............#................X....X.#............#.#....."
    ],
    [
        "...............................................#.#....#.....X..........X..............#...............X...#X.....................#"
    ],
    [
        ".....#...........#........#.#.......#.......................X.....#....X.............#................X....X......................"
    ],
    [
        "...............#............................................X..........X.#....................#.......X....X....#.............#..."
    ],
    [
        "#....................................##..........#..........X..........X...........#<XXXXXXXXXXXXXXXXXXXXXXX......#..............."
    ],
    [
        "...............#.................#...#..............#.......X..........X..............................X....#..............#......."
    ],
    [
        "...................#......#.................................X..........X#.............................X........................#.#"
    ],
    [
        "..#.............#.......#......#....#..#..#.................X..........X..............................X..........................."
    ],
    [
        ".........#..................................................X.#........X............................#.X............#.............."
    ],
    [
        "..............#..............#..............................X..........X......................#.......X...............#..........."
    ],
    [
        "..........................#.................#...............X..........X............................##X..................#.#......"
    ],
    [
        "...............#..#.........................................X..........X..............................X...............#.......###."
    ],
    [
        "...#.....................#..#........#..........#...........X..........X..............................X............##............."
    ],
    [
        ".................#.......................................###X..........X..#.........................#.X..........................."
    ],
    [
        "...#.....................................................#..X....#.....X....................#.........X......#..#................."
    ],
    [
        "...................................................#........X.........#X..............................X.........................#."
    ],
    [
        ".....#.............#...................#...................#X..........X.........................#....X..........................."
    ],
    [
        ".....................#.........................#......#.....X..........X..............................X..........................."
    ],
    [
        "...........#...............#......#.....##...#...#..........X..........X.......................#......X.#.#...............#...#..."
    ],
    [
        "..............#..............##...........#.................X.....#..#.X..............................X..........................."
    ],
    [
        "...................#........................................X.........................................X..........................."
    ],
    [
        "..................#.......#..........#.......#..............X...#..........#..........................X........#.................."
    ],
    [
        "............................................................X.................................#.......X..........................#"
    ],
    [
        "......................................................#.....X..........#......................#.......X..........................."
    ],
    [
        "..............#.........#..............................#....X................#......................#.X..........................."
    ],
    [
        "#................#.........#................#...............X.............#......................#..#.X.#..............#.........."
    ],
    [
        ".#..#........#................#...............#.............X....#........#.....................#.....X......#........#..........."
    ],
    [
        ".....................................................#.#....X....#......................#.............X...............#........#.."
    ],
    [
        "......................#.....................#..#......#.....X....................#....................X.......#......#............"
    ],
    [
        "......................#.........................#..#........X.........................#...............X.......#..............#...."
    ],
    [
        "..........................#..................#.............#XXXXXXXXXXXXXXXXXXXXXXXXXXXXXXXXXXXXXXXXXXX...........#..............."
    ],
    [
        "..........................#....#........................................#..#...#....#.................#..........................."
    ],
    [
        ".......#...........#.......................#............##........#....................................................#.........."
    ],
    [
        "#..........................................................................#...........#.........................................."
    ],
    [
        "............................................................#.................#..#........................................##......"
    ],
    [
        "..#...............................................#....#.................................................##.....#...##.....#......"
    ],
    [
        "...#.....##..............................#.........................................................#............#................."
    ],
    [
        ".....#....##............................#....##..........#...#...................................................................."
    ],
    [
        "..................................................#..........................#.........##.......#.......................#........."
    ],
    [
        ".........#.....#..........#........#........................#.##..#............#.......................................#.........."
    ],
    [
        ".....#...............#.......#..........#.#..........#.....................#.....................................#.....#.........."
    ],
    [
        "....#......#............................................................................................##...#.#.#.........#......"
    ],
    [
        "...........#........................#.....#....................#..................#.#........#...................................."
    ],
    [
        "....................................................#................#.#................................................#........."
    ],
    [
        "..........#..............#.......................#.................#...................................#.............#.#......##.."
    ],
    [
        "................##......................................................#.................#.......#.#....................#........"
    ],
    [
        "................#......................................................#.............##...............#.....#......#.......#......"
    ],
    [
        "..............................#............................#..........#...........#..............................................."
    ],
    [
        ".......#.............#....................................................................#..............................#.#......"
    ],
    [
        "...#.....................#.#...............................................................#...#..#....#.........................."
    ],
    [
        "....#.........##......#..............................................................................#..................#........."
    ],
    [
        "....#..........................................#......#...................#........##............#................................"
    ],
    [
        "..#.......#......#............#........#...#.#...........................#.......#................................................"
    ],
    [
        "..........................#...#....................#...............#...#......#.#...#...#...............#.#.#....................."
    ],
    [
        "....##.#....................................................................#...#.....##........................#.##.............."
    ],
    [
        ".............................................#...................................................................................."
    ]
]