[
    [
        "...#..................#...................#......................#..............................#.............................#..."
    ],
    [
        "....#.......................#........#.#..............##...........#.....#..........#..........................#.................."
    ],
    [
        ".............#........................................................................#.........#.#..#..#..........#.............."
    ],
    [
        "..........#.......#..........#..................#........##...................#..............#...................................."
    ],
    [
        "....................#..........................................................#..#.....................................#........."
    ],
    [
        "....#............................#..............................................#.....................#..........##....#.........."
    ],
    [
        ".......#.............#......................................................................#.............#.........#............."
    ],
    [
        "....###......................#....#...........#.....#................................#..........................#................."
    ],
    [
        "..........#..#...........#..#........................................................#.....#...........#................#........."
    ],
    [
        "..#....#......#....#....#...................................................................#....................................."
    ],
    [
        "....................#............#............................................#......#....#...............................#......."
    ],
    [
        "..........#.......#.........#.......#............................................................................................."
    ],
    [
        ".......#...#.......................................#...................#.........................................................."
    ],
    [
        ".......#........#............................#.....#.......#..............................................#..................#...#"
    ],
    [
        ".....................#.................................#................#...#...............#.....#.#..........................#.."
    ],
    [
        ".....#..........................................#......................#.............##..............................#........#..."
    ],
    [
        ".....#......#.........................#..........................#..........................................................#..#.."
    ],
    [
        ".#......#.............#......#.................................................#.....#...................##......#................"
    ],
    [
        ".............................................................................##..................................................."
    ],
    [
        "........................................#.......................................#........#.............................#.#.......#"
    ],
    [
        "...........#.....................................#.............................#......#......#..#....................#..#........."
    ],
    [
        ".............................................#.......................#..................##....#.....#............................."
    ],
    [
        "........................#..............................................................#.........................................."
    ],
    [
        "#..............#.........................#........#...#...............#..............#..................#....................##..."
    ],
    [
        "...#...#.............................#.......#................................................#........................#....#....."
    ],
    [
        ".....#.........................#..#.......................#..........#.....................#..................#.#.....#..........."
    ],
    [
        "..................#........#..#.......#...................................................................................#....#.."
    ],
    [
        "..#...#...............................................#.#..#........................................................#....#......#."
    ],
    [
        "...............#...............#..........................#............................#..........#.............#................."
    ],
    [
        "............#.....#........#.........................................................#........#........#.....#........#......#...."
    ],
    [
        "............................#.........#....#........#.....#...#.............#.................................#..................."
    ],
    [
        "........#..................#....#..........................................................#.#.#.................................."
    ],
    [
        "................................XXXXXXXXXXXXXXXXXXXXXXXXXXXXXXXXXXXXXXXXXX>#........................................#............."
    ],
    [
        "#............#.............#....X.............#......................................................................#............"
    ],
    [
        "...............................#X...#..........#...........##........................................................#.........#.#"
    ],
    [
        "................#...............X.........................#.XXXXXXXXXXXXXXXXXXXXXXXXXXXXXXXXXXXXXXXXXXXXXXXX#........#............"
    ],
    [
        "................................X.............#............#X...............#........#.....................X..#..................."
    ],
    [
        "..................#.........#...X......................#....X........#...............#............#........X...........#.........."
    ],
    [
        "........................#...#...X...........................X...............#..............#.....#.........X...........#.........."
    ],
    [
        "...........#....................X..................#........X.....................#..................#....#X..##.................."
    ],
    [
        "#...............#...............X..#........................X......#...............................#.......X.............#........"
    ],
    [
        ".............#..................X...........................X................##............................X......................"
    ],
    [
        ".................#.............#X......................#...#X...........#.#....#...........................X....#...........#....."
    ],
    [
        "#......#......#.................X................##.........X.......#.#...............................#....X......................"
    ],
    [
        ".#...............#..........#...X.................XXXXXXXXXXXXXXXXXXXXXXXXXX#...#..........#..........#....X......................"
    ],
    [
        "................................X....#............X.........X.....#....#...X...............................X.........#...#........"
    ],
    [
        "......#...#.............#.#.....X..............#..X......#..X.......##.XXXXXXXXXXXXXXXXXXXXXXXXXXXXXXXX#...X......#..........#...."
    ],
    [
        ".............................#..X...............#.X..#......X.......##.X...X.................#.#.....#X....X..#..................."
    ],
    [
        "................................X................#X#........X..........X...X..........................X...#X...............#......"
    ],
    [
        "................................X.....#...........X.........X..........X...X.....#......#.............X....X......................"
    ],
    [
        "#....................#..........X.................X.........X..........X...X.....#..................#.X....X......................"
    ],
    [
        ".....#.........#................X.................X.........X......#...X#.#X...#.#.........#..........X....X......................"
    ],
    [
        "........#..........#......#.....X.......#.........X.........X..........X.#.X...#................#.....X....X......................"
    ],
    [
        "...........#....................X...........#.....X.....#...X......#...X..#X............#.............X....X.....#................"
    ],
    [
        ".......#...............#........X...........#..#..X.........X..........X...X....................#.....X....X......................"
    ],
    [
        ".....................#.........#X.#............#..X.......#.X.........#X...X......#...................X....X......#..............."
    ],
    [
        "................#...#........#..X........#........X.........X..........X...X........................#.X#...X...............#......"
    ],
    [
        "....................XXXXXXXXXXXXXXXXXXXXXXXXXXXXXXXXXXXXX#..X..........X...X...#...#..................X...#X#....................#"
    ],
    [
        "................#...X..#....#.#.X............#....X.....X.#.X..........X...X..........................X....X......................"
    ],
    [
        "..........#.........X...........X...............#.X.....X...X..........X...X..........................X....X...........#.........."
    ],
    [
        "#...................X...........X......#.......#..X..##.X#..X..........X...X...#.........#.......#....X....X......................"
    ],
    [
        "........#...#.......X......#....X...............#.X.....X...X..........X...X.....#....................X....X....................#."
    ],
    [
        ".##.................X...........X.................X.....X...X..........X...X...#......#...............X....X...........#.........."
    ],
    [
        ".#..................X.....#.....X........#........X.....X...X..........X...X............#........#....X#...X...#.................."
    ],
    [
        "#...................X...........X......#..........X.....X...X#.........X...X..........................X....X.....................#"
    ],
    [
        "....................X.......#...X.#.....#.........X..#..X...X........#.X.#.X.....#.........#..........X....X......................"
    ],
    [
        ".#..................X......#....X.................X#....X...X#.......#.X...X...........#..............X....X........#..#.........."
    ],
    [
        "....................X...........X.................X.....X...X..........X...X..........................X....X.#........##.........."
    ],
    [
        "...........#...#...#X#..........X.....#...........X.....X...X..........X...X#........#................X....X......................"
    ],
    [
        "......#.............X.........#.X........#.......#X.....X...X..........X...X..........................X....X......#..............."
    ],
    [
        "........#....#......X.#.........X........#....##..X..#..X...X.....#....X...X.....................#....X....X.#...........#..#....."
    ],
    [
        "....................X...........X.#...............X.....X...X..........X...X..........................X....X......#..............."
    ],
    [
        "....................X#.#........X..............#..X.....X...X..........X...X........#.................X....X......................"
    ],
    [
        "....................X...........X.................X.....X...X..........X...X............#.........#...X....X........#.........#..."
    ],
    [
        "....................X.....#.....X....#....#.......X.....X...X..........X...X.........#................X....X.#............#.#....."
    ],
    [
        "....................X...........X..............#.#X...#.X...X..........X...X..........#...............X...#X.....................#"
    ],
    [
        ".....#...........#..X.....#.#...X...#.............X.....X...X.....#....X...X.........#................X....X......................"
    ],
    [
        "...............#....X...........X.................X.....X...X..........X.#.X..................#.......X....X....#.............#..."
    ],
    [
        "#...................X...........X....##..........#XXXXXXXXXXXXXXXXXXXXXXXXXXXXXXXXXXXXXXXXXXXXXXXXXXXXXXXXXX......#..............."
    ],
    [
        "...............#....X...........X#...#..............#...X...X..........X...X..........................X....#..............#......."
    ],
    [
        "...................#X.....#.....X.......................X...X..........X#..X..........................X........................#.#"
    ],
    [
        "..#.............#...X...#......#X...#..#..#.............X...X..........X...X..........................X..........................."
    ],
    [
        ".........#..........X...........X.......................X...X.#........X...X........................#.X............#.............."
    ],
    [
        "..............#.....X........#..X.......................X...X..........X...X..................#.......X...............#..........."
    ],
    [
        "....................X.....#.....X...........#...........X...X..........X...X........................##X..................#.#......"
    ],
    [
        "...............#..#.X...........X.......................X...X..........X...X..........................X...............#.......###."
    ],
    [
        "...#................X....#..#...X....#..........#.......X...X..........X...X..........................X............##............."
    ],
    [
        ".................#..X...........X.......................X###X..........X..#X........................#.X..........................."
    ],
    [
        "...#................X...........X.......................X#..X....#.....X...X................#.........X......#..#................."
    ],
    [
        "....................X...........X..................#....X...X.........#X...X..........................X.........................#."
    ],
    [
        ".....#.............#X...........X......#................X..#X..........X...X.....................#....X..........................."
    ],
    [
        "....................X#..........X..............#......#.X...X..........X...X..........................X..........................."
    ],
    [
        "...........#........X......#....X.#.....##...#...#......X...X..........X...X...................#......X.#.#...............#...#..."
    ],
    [
        "..............#.....X........##.X.........#.............X...X.....#..#.X...X..........................X..........................."
    ],
    [
        "...................#XXXXXXXXXXXXXXXXXXXXXXXXXXXXXXXXXXXXXXXXXXXXXXXXXXXXXXXX..........................X..........................."
    ],
    [
        "..................#.......#.....X....#.......#..........X...X...#..........#..........................X........#.................."
    ],
    [
        "................................X.......................X...X.................................#.......X..........................#"
    ],
    [
        "................................X.....................#.X...X..........#......................#.......X..........................."
    ],
    [
        "..............#.........#.......X......................#X...X................#......................#.X..........................."
    ],
    [
        "#................#.........#....X...........#...........X...X.............#......................#..#.X.#..............#.........."
    ],
    [
        ".#..#........#................#.X.............#.........X...X....#........#.....................#.....X......#........#..........."
    ],
    [
        "................................X....................#.#X...X....#......................#.............X...............#........#.."
    ],
    [
        "......................#.........X...........#..#......#.X...X....................#....................X.......#......#............"
    ],
    [
        "......................#.........X...............#..#....X...X.........................#...............X.......#..............#...."
    ],
    [
        "..........................#.....X............#..........X..#XXXXXXXXXXXXXXXXXXXXXXXXXXXXXXXXXXXXXXXXXXX...........#..............."
    ],
    [
        "..........................#....#XXXXXXXXXXXXXXXXXXXXXXXXX...............#..#...#....#.................#..........................."
    ],
    [
        ".......#...........#.......................#............##........#....................................................#.........."
    ],
    [
        "#..........................................................................#...........#.........................................."
    ],
    [
        "............................................................#.................#..#........................................##......"
    ],
    [
        "..#...............................................#....#.................................................##.....#...##.....#......"
    ],
    [
        "...#.....##..............................#.........................................................#............#................."
    ],
    [
        ".....#....##............................#....##..........#...#...................................................................."
    ],
    [
        "..................................................#..........................#.........##.......#.......................#........."
    ],
    [
        ".........#.....#..........#........#........................#.##..#............#.......................................#.........."
    ],
    [
        ".....#...............#.......#..........#.#..........#.....................#.....................................#.....#.........."
    ],
    [
        "....#......#............................................................................................##...#.#.#.........#......"
    ],
    [
        "...........#........................#.....#....................#..................#.#........#...................................."
    ],
    [
        "....................................................#................#.#................................................#........."
    ],
    [
        "..........#..............#.......................#.................#...................................#.............#.#......##.."
    ],
    [
        "................##......................................................#.................#.......#.#....................#........"
    ],
    [
        "................#......................................................#.............##...............#.....#......#.......#......"
    ],
    [
        "..............................#............................#..........#...........#..............................................."
    ],
    [
        ".......#.............#....................................................................#..............................#.#......"
    ],
    [
        "...#.....................#.#...............................................................#...#..#....#.........................."
    ],
    [
        "....#.........##......#..............................................................................#..................#........."
    ],
    [
        "....#..........................................#......#...................#........##............#................................"
    ],
    [
        "..#.......#......#............#........#...#.#...........................#.......#................................................"
    ],
    [
        "..........................#...#....................#...............#...#......#.#...#...#...............#.#.#....................."
    ],
    [
        "....##.#....................................................................#...#.....##........................#.##.............."
    ],
    [
        ".............................................#...................................................................................."
    ]
]