[
    [
        "...#..................#...................#......................#..............................#.............................#..."
    ],
    [
        "....#.......................#........#.#..............##...........#.....#..........#..........................#.................."
    ],
    [
        ".............#........................................................................#.........#.#..#..#..........#.............."
    ],
    [
        "..........#.......#..........#..................#........##...................#..............#...................................."
    ],
    [
        "....................#..........................................................#..#.....................................#........."
    ],
    [
        "....#............................#..............................................#.....................#..........##....#.........."
    ],
    [
        ".......#.............#......................................................................#.............#.........#............."
    ],
    [
        "....###......................#....#...........#.....#................................#..........................#................."
    ],
    [
        "..........#..#...........#..#........................................................#.....#...........#................#........."
    ],
    [
        "..#....#......#....#....#...................................................................#....................................."
    ],
    [
        "....................#............#............................................#......#....#...............................#......."
    ],
    [
        "..........#.......#.........#.......#............................................................................................."
    ],
    [
        ".......#...#.......................................#...................#.........................................................."
    ],
    [
        ".......#........#............................#.....#.......#..............................................#..................#...#"
    ],
    [
        ".....................#.................................#................#...#...............#.....#.#..........................#.."
    ],
    [
        ".....#..........................................#......................#.............##..............................#........#..."
    ],
    [
        ".....#......#.........................#..........................#..........................................................#..#.."
    ],
    [
        ".#......#.............#......#.................................................#.....#...................##......#................"
    ],
    [
        ".............................................................................##..................................................."
    ],
    [
        "........................................#.......................................#........#.............................#.#.......#"
    ],
    [
        "...........#.....................................#.............................#......#......#..#....................#..#........."
    ],
    [
        ".............................................#.......................#..................##....#.....#............................."
    ],
    [
        "........................#..............................................................#.........................................."
    ],
    [
        "#..............#.........................#........#...#...............#..............#..................#....................##..."
    ],
    [
        "...#...#.............................#.......#................................................#........................#....#....."
    ],
    [
        ".....#.........................#..#.......................#..........#.....................#..................#.#.....#..........."
    ],
    [
        "..................#........#..#.......#...................................................................................#....#.."
    ],
    [
        "..#...#...............................................#.#..#........................................................#....#......#."
    ],
    [
        "...............#...............#..........................#............................#..........#.............#................."
    ],
    [
        "............#.....#........#.........................................................#........#........#.....#........#......#...."
    ],
    [
        "............................#.........#....#........#.....#...#.............#.................................#..................."
    ],
    [
        "........#..................#....#..........XXXXXXXXXXXXXXXXXXXXXXXXXXXXXXXXXXXXXXXXXXXXXXXX#.#.#.................................."
    ],
    [
        "................................XXXXXXXXXXXXXXXXXXXXXXXXXXXXXXXXXXXXXXXXXXXXXXXXXXXXXXXXXXXXXXXXXXXXXXXXXXXXXXXXXXXX#............."
    ],
    [
        "#............#.............#....X..........X..#...........................................X........................X.#............"
    ],
    [
        "...............................#X...#......X...#...........##.............................X........................X.#.........#.#"
    ],
    [
        "................#...............X..........X..............#.XXXXXXXXXXXXXXXXXXXXXXXXXXXXXXXXXXXXXXXXXXXXXXXX#......X.#............"
    ],
    [
        "................................X..........X..#............#X...............#........#....X................X..#....X.............."
    ],
    [
        "..................#.........#...X..........X...........#....X........#...............#....X.......#........X.......X...#.........."
    ],
    [
        "........................#...#...X..........X................X...............#.............X#.....#.........X.......X...#.........."
    ],
    [
        "...........#....................X..........X.......#........X.....................#.......X..........#....#X..##...X.............."
    ],
    [
        "#...............#...............X..#.......X................X......#......................X........#.......X.......X.....#........"
    ],
    [
        ".............#..................X..........X................X................##...........X................X.......X.............."
    ],
    [
        ".................#.............#X..........X...........#...#X...........#.#....#..........X................X....#..X........#....."
    ],
    [
        "#......#......#.................X..........X.....##.........X.......#.#...................X...........#....X.......X.............."
    ],
    [
        ".#...............#..........#...X..........X......XXXXXXXXXXXXXXXXXXXXXXXXXX#...#.........X#..........#....X.......X.............."
    ],
    [
        "................................X....#.....X......X.........X.....#....#...X..............X................X.......X.#...#........"
    ],
    [
        "......#...#.............#.#.....X..........X...#..X......#..X.......##.XXXXXXXXXXXXXXXXXXXXXXXXXXXXXXXX#...X......#X.........#...."
    ],
    [
        ".............................#..X..........X....#.X..#......X.......##.X...X..............X..#.#.....#X....X..#....X.............."
    ],
    [
        "................................X..........X.....#X#........X.......XXXXXXXXXXXXXXXXXXXXXXXXXXXXXXXXXXXXXX#X.......X.......#......"
    ],
    [
        "................................X.....#....X......X.........X.......X..X...X.....#......#.X...........X..X.X.......X.............."
    ],
    [
        "#....................#..........X..........X......X.........X.......X..X...X.....#........X.........#.X..X.X.......X.............."
    ],
    [
        ".....#.........#................X..........X......X.........X......#X..X#.#X...#.#........X#..........X..X.X.......X.............."
    ],
    [
        "........#..........#......#.....X.......#..X......X.........X.......X..X.#.X...#..........X.....#.....X..X.X.......X.............."
    ],
    [
        "...........#....................X..........X#.....X.....#...X......#X..X..#X............#.X...........X..X.X.....#.X.............."
    ],
    [
        ".......#...............#........X..........X#..#..X.........X.......X..X...X..............X.....#.....X..X.X.......X.............."
    ],
    [
        ".....................#.........#X.#........X...#..X.......#.X.......X.#X...X......#.......X...........X..X.X......#X.............."
    ],
    [
        "................#...#........#..X........#.X......X.........X.......X..X...X......XXXXXXXXXXXXXX>#..#.X#.X.X.......X.......#......"
    ],
    [
        "....................XXXXXXXXXXXXXXXXXXXXXXXXXXXXXXXXXXXXX#..X.......X..X...X...#..X#......X...........X..X#X#......X.............#"
    ],
    [
        "................#...X..#....#.#.X..........X.#....X.....X.#.X.......X..X...X......X.......X...........X..X.X.......X.............."
    ],
    [
        "..........#.........X...........X..........X....#.X.....X...X.......X..X...X......X.......X...........X..X.X.......X...#.........."
    ],
    [
        "#...................X...........X......#...X...#..X..##.X#..X.......X..X...X...#..X......#X......#....X..X.X.......X.............."
    ],
    [
        "........#...#.......X......#....X..........X....#.X.....X...X.......X..X...X.....#X.......X...........X..X.X.......X............#."
    ],
    [
        ".##.................X...........X..........X......X.....X...X.......X..X...X...#..X...#...X...........X..X.X.......X...#.........."
    ],
    [
        ".#..................X.....#.....X........#.X......X.....X...X.......X..X...X......X.....#.X......#....X#.X.X...#...X.............."
    ],
    [
        "#...................X...........X......#...X......X.....X...X#......X..X...X......X.......X...........X..X.X.......X.............#"
    ],
    [
        "....................X.......#...X.#.....#..X......X..#..X...X.......X#.X.#.X.....#X.......X#..........X..X.X.......X.............."
    ],
    [
        ".#..................X......#....X..........X......X#....X...X#......X#.X...X......X....#..X...........X..X.X.......X#..#.........."
    ],
    [
        "....................X...........X..........X......X.....X...X.......X..X...X......X.......X...........X..X.X.#.....X..##.........."
    ],
    [
        "...........#...#...#X#..........X.....#....X......X.....X...X.......X..X...X#.....X..#....X...........X..X.X.......X.............."
    ],
    [
        "......#.............X.........#.X........#.X.....#X.....X...X.......X..X...X......X.......X...........X..X.X......#X.............."
    ],
    [
        "........#....#......X.#.........X........#.X..##..X..#..X...X.....#.X..X...X......X.......X......#....X..X.X.#.....X.....#..#....."
    ],
    [
        "....................X...........X.#........X......X.....X...X.......X..X...X......X.......X...........X..X.X......#X.............."
    ],
    [
        "....................X#.#........X..........X...#..X.....X...X.......X..X...X......X.#.....X...........X..X.X.......X.............."
    ],
    [
        "....................X...........X..........X......X.....X...X.......X..X...X......X.....#.X.......#...X..X.X.......X#.........#..."
    ],
    [
        "....................X.....#.....X....#....#X......X.....X...X.......X..X...X......X..#....X...........X..X.X.#.....X......#.#....."
    ],
    [
        "....................X...........X..........X...#.#X...#.X...X.......X..X...X......X...#...X...........X..X#X.......X.............#"
    ],
    [
        ".....#...........#..X.....#.#...X...#......X......X.....X...X.....#.X..X...X......X..#....X...........X..X.X.......X.............."
    ],
    [
        "...............#....X...........X..........X......X.....X...X.......X..X.#.X......X.......X...#.......X..X.X....#..X..........#..."
    ],
    [
        "#...................X...........X....##....X.....#XXXXXXXXXXXXXXXXXXXXXXXXXXXXXXXXXXXXXXXXXXXXXXXXXXXXXXXXXX......#X.............."
    ],
    [
        "...............#....X...........X#...#.....X........#...X...X.......X..X...X......X.......X...........X..X.#.......X......#......."
    ],
    [
        "...................#X.....#.....X..........X............X...X.......X..X#..X......X.......X...........X..X.........X...........#.#"
    ],
    [
        "..#.............#...X...#......#X...#..#..#XXXXXXXXXXXXXXXXXXXXXXXXXXXXXXXXXXXXXXXXXXXXXXXXXXXXXXXXXXXXXXXXXXXXXXXXX.............."
    ],
    [
        ".........#..........X...........X.......................X...X.#.....X..X...X......X.......X.........#.X..X.........#.............."
    ],
    [
        "..............#.....X........#..X.......................X...X.......X..X...X......X.......X...#.......X..X............#..........."
    ],
    [
        "....................X.....#.....X...........#...........X...X.......X..X...X......X.......X.........##X..X...............#.#......"
    ],
    [
        "...............#..#.X...........X.......................X...X.......X..X...X......X.......X...........X..X............#.......###."
    ],
    [
        "...#................X....#..#...X....#..........#.......X...X.......X..X...X......X.......X...........X..X.........##............."
    ],
    [
        ".................#..X...........X.......................X###X.......X..X..#X......X.......X.........#.X..X........................"
    ],
    [
        "...#................X...........X.......................X#..X....#..X..X...X......X.......X.#.........X..X...#..#................."
    ],
    [
        "....................X...........X..................#....X...X.......X.#X...X......X.......X...........X..X......................#."
    ],
    [
        ".....#.............#X...........X......#................X..#X.......X..X...X......X.......X......#....X..X........................"
    ],
    [
        "....................X#..........X..............#......#.X...X.......X..X...X......X.......X...........X..X........................"
    ],
    [
        "...........#........X......#....X.#.....##...#...#......X...X.......X..X...X......X.......X....#......X.#X#...............#...#..."
    ],
    [
        "..............#.....X........##.X.........#.............X...X.....#.X#.X...X......X.......X...........X..X........................"
    ],
    [
        "...................#XXXXXXXXXXXXXXXXXXXXXXXXXXXXXXXXXXXXXXXXXXXXXXXXXXXXXXXX......X.......X...........X..X........................"
    ],
    [
        "..................#.......#.....X....#.......#..........X...X...#...X......#......X.......X...........X..X.....#.................."
    ],
    [
        "................................X.......................X...X.......X.............X.......X...#.......X..X.......................#"
    ],
    [
        "................................X.....................#.X...X.......X..#..........X.......X...#.......X..X........................"
    ],
    [
        "..............#.........#.......X......................#X...X.......X........#....X.......X.........#.X..X........................"
    ],
    [
        "#................#.........#....X...........#...........X...X.......X.....#.......X.......X......#..#.X.#X.............#.........."
    ],
    [
        ".#..#........#................#.X.............#.........X...X....#..X.....#.......X.......X.....#.....X..X...#........#..........."
    ],
    [
        "................................X....................#.#X...X....#..X.............X.....#.X...........X..X............#........#.."
    ],
    [
        "......................#.........X...........#..#......#.X...X.......X............#X.......X...........X..X....#......#............"
    ],
    [
        "......................#.........X...............#..#....X...X.......X.............X...#...X...........X..X....#..............#...."
    ],
    [
        "..........................#.....X............#..........X..#XXXXXXXXXXXXXXXXXXXXXXXXXXXXXXXXXXXXXXXXXXX..X........#..............."
    ],
    [
        "..........................#....#XXXXXXXXXXXXXXXXXXXXXXXXX...........X...#..#...#..X.#.....X...........#..X........................"
    ],
    [
        ".......#...........#.......................#............##........#.X.............X.......X..............X.............#.........."
    ],
    [
        "#...................................................................X......#......X....#..X..............X........................"
    ],
    [
        "............................................................#.......X.........#..#XXXXXXXXXXXXXXXXXXXXXXXX................##......"
    ],
    [
        "..#...............................................#....#............X.....................X..............##.....#...##.....#......"
    ],
    [
        "...#.....##..............................#..........................X.....................X........#............#................."
    ],
    [
        ".....#....##............................#....##..........#...#......X.....................X......................................."
    ],
    [
        "..................................................#.................X........#.........##.X.....#.......................#........."
    ],
    [
        ".........#.....#..........#........#........................#.##..#.X..........#..........X............................#.........."
    ],
    [
        ".....#...............#.......#..........#.#..........#..............X......#..............X......................#.....#.........."
    ],
    [
        "....#......#........................................................X.....................X.............##...#.#.#.........#......"
    ],
    [
        "...........#........................#.....#....................#....X.............#.#.....X..#...................................."
    ],
    [
        "....................................................#...............X#.#..................X.............................#........."
    ],
    [
        "..........#..............#.......................#.................#XXXXXXXXXXXXXXXXXXXXXXX............#.............#.#......##.."
    ],
    [
        "................##......................................................#.................#.......#.#....................#........"
    ],
    [
        "................#......................................................#.............##...............#.....#......#.......#......"
    ],
    [
        "..............................#............................#..........#...........#..............................................."
    ],
    [
        ".......#.............#....................................................................#..............................#.#......"
    ],
    [
        "...#.....................#.#...............................................................#...#..#....#.........................."
    ],
    [
        "....#.........##......#..............................................................................#..................#........."
    ],
    [
        "....#..........................................#......#...................#........##............#................................"
    ],
    [
        "..#.......#......#............#........#...#.#...........................#.......#................................................"
    ],
    [
        "..........................#...#....................#...............#...#......#.#...#...#...............#.#.#....................."
    ],
    [
        "....##.#....................................................................#...#.....##........................#.##.............."
    ],
    [
        ".............................................#...................................................................................."
    ]
]