[
    [
        "....#....."
    ],
    [
        "....XXXXX#"
    ],
    [
        "....X...X."
    ],
    [
        "..#.X...X."
    ],
    [
        "..XXXXX#v."
    ],
    [
        "..X.X.X.#."
    ],
    [
        ".#XXXXXXX."
    ],
    [
        ".XXXXXXX#."
    ],
    [
        "#XXXXXXX.."
    ],
    [
        "......#X.."
    ]
]