[
    [
        "....#....."
    ],
    [
        "....XXXXX#"
    ],
    [
        "....X...v."
    ],
    [
        "..#.X...#."
    ],
    [
        "..XXXXX#X."
    ],
    [
        "..X.X.X.X."
    ],
    [
        ".#XXXXXXX."
    ],
    [
        ".XXXXXXX#."
    ],
    [
        "#XXXXXXX.."
    ],
    [
        "......#X.."
    ]
]